{
    "compose_ids": [
        134257216, 
        134268943, 
        134233952, 
        134244701, 
        134280428, 
        201390095, 
        201390094, 
        201390093, 
        201390091, 
        201390090, 
        201390089, 
        201390087, 
        201390088, 
        201390085, 
        201390086, 
        201390081, 
        201390082, 
        134245059, 
        134238903, 
        201390083, 
        201390084, 
        201390096, 
        201390097, 
        134278589, 
        134257065, 
        134264126, 
        134253385, 
        134243995, 
        134267045, 
        134275213, 
        134278629, 
        134280087, 
        134218218, 
        134262923, 
        134262215, 
        134233763, 
        134255180, 
        134224775, 
        134218624, 
        134221867, 
        134240232, 
        134257384, 
        134234796, 
        134229235, 
        134253920, 
        134275099, 
        134273700, 
        201390092, 
        134258256, 
        134276637, 
        134269247, 
        134250786, 
        134257230, 
        134250168, 
        134233693, 
        134277246, 
        201390023, 
        201390024, 
        201390001, 
        201390002, 
        134245520, 
        134253209, 
        134266379, 
        134240669, 
        134280991, 
        134228060, 
        134277421, 
        134238400, 
        134246592, 
        134269921, 
        134248332, 
        134281090, 
        134264679, 
        134245094, 
        134255884, 
        134242639, 
        134229581, 
        134266974, 
        134259106, 
        134236610, 
        134234279, 
        134265127, 
        134280441, 
        134267038, 
        134269776, 
        134274551, 
        134251416, 
        134226645, 
        134239816, 
        134262850, 
        134221444, 
        134228361, 
        134262000, 
        134247724, 
        134220260, 
        134260300, 
        134239993, 
        134235972, 
        134279768, 
        134270714, 
        134227238, 
        134233512, 
        134259128, 
        134238587, 
        134266482, 
        134231128, 
        134217850, 
        134218809, 
        134244688, 
        134271180, 
        134240214, 
        134258875, 
        134228411, 
        134279927, 
        134271045, 
        134240705, 
        134253620, 
        134224105, 
        134272769, 
        134235000, 
        134244069, 
        134238591, 
        134245925, 
        134282973, 
        134240163, 
        134282679, 
        134251903, 
        134222311, 
        134218769, 
        134230472, 
        134267197, 
        134228456, 
        134240378, 
        134249789, 
        134231405, 
        134233922, 
        134230384, 
        134227155, 
        134280697, 
        134239039, 
        134281875, 
        134223138, 
        134279183, 
        134242657, 
        134247558
    ], 
    "item_id_seed": 0
}